long,lat,confidence,year,week,area,emissions,climate_mask,iso,adm1,adm2,alert_count
10.102875,-0.000625,3,2018,7,769.317,26.65625,0,GAB,GAB.1_1,GAB.1.1_1,1
10.346625,-0.000625,3,2018,7,769.317,19.875,0,GAB,GAB.1_1,GAB.1.1_1,1
10.346875,-0.000625,3,2018,7,769.317,18.75,0,GAB,GAB.1_1,GAB.1.1_1,1
19.380875,0.000125,3,2018,7,769.317,0.0,1,COD,COD.2_1,COD.2.4_1,1
19.413626,0.000125,3,2018,7,769.317,0.0,1,COD,COD.2_1,COD.2.4_1,1
19.668875,0.000125,3,2018,7,769.317,0.0,1,COD,COD.2_1,COD.2.4_1,1
19.669125,0.000125,3,2018,7,769.317,0.0,1,COD,COD.2_1,COD.2.4_1,1
19.669374,0.000125,3,2018,7,769.317,0.0,1,COD,COD.2_1,COD.2.4_1,1
19.669624,0.000125,3,2018,7,769.317,0.0,1,COD,COD.2_1,COD.2.4_1,1